NO /home/miguel/projects/42_cub3d/textures/bluestone.xpm
SO /home/miguel/projects/42_cub3d/textures/eagle.xpm
WE /home/miguel/projects/42_cub3d/textures/greystone.xpm
EA /home/miguel/projects/42_cub3d/textures/redbrick.xpm

F 225,100,0
C 225,30,0

1111111111111111111111111
1000000000000000000000001
10110000000E0100000000001
1001000000000000110000001
1111111111111111111111111
